male	female
countryman	countrywoman
fraternal	sororal
wizards	witches
manservant	maidservant
fathers	mothers
divo	diva
actor	actress
bachelor	spinster
papa	mama
dukes	duchesses
barman	barwoman
countrymen	countrywomen
brideprice	dowry
hosts	hostesses
airmen	airwomen
andropause	menopause
penis	clitoris
prince	princess
governors	governesses
abbot	abbess
men	women
widower	widow
gentlemen	ladies
sorcerers	sorceresses
sir	madam
bridegrooms	brides
baron	baroness
househusbands	housewives
gods	godesses
nephew	niece
widowers	widows
lord	lady
brother	sister
grooms	brides
priest	nun
adultors	adultresses
andrology	obstetrics
bellboys	bellgirls
his	her
marquis	marchioness
princes	princesses
emperors	empresses
stallion	mare
chairman	chairwoman
monastery	convent
priests	priestesses
boyhood	girlhood
fellas	ladies
king	queen
dudes	gals
daddies	mommies
manservant	maid
semen	female_ejaculation
spokesman	spokeswoman
tailor	seamstress
cowboys	cowgirls
dude	chick
bachelors	spinsters
barbershop	hair_salon
emperor	empress
daddy	mommy
masculism	feminism
guys	gals
enchanter	enchantress
guy	gal
fatherhood	motherhood
androgen	estrogen
cameramen	camerawomen
godfather	godmother
strongman	strongwoman
god	goddess
patriarch	matriarch
uncle	aunt
chairmen	chairwomen
sir	ma'am
brotherhood	sisterhood
host	hostess
testosterone	estradiol
husband	wife
dad	mom
steward	stewardess
males	females
cialis	viagra
spokesmen	spokeswomen
pa	ma
beau	belle
stud	minx
bachelor	maiden
wizard	witch
sir	miss
nephews	nieces
fathered	mothered
bull	cow
beaus	belles
councilmen	councilwomen
landlords	landladies
grandson	granddaughter
fiances	fiancees
stepfathers	stepmothers
horsemen	horsewomen
grandfathers	grandmothers
adultor	adultress
schoolboy	schoolgirl
rooster	hen
grandsons	granddaughters
bachelor	bachelorette
cameraman	camerawoman
dads	moms
him	her
master	mistress
lad	lass
policeman	policewoman
monk	nun
actors	actresses
salesmen	saleswomen
boyfriend	girlfriend
councilman	councilwoman
fella	lady
statesman	stateswoman
paternal	maternal
chap	lass
landlord	landlady
brethren	sistren
lords	ladies
blokes	wenches
fraternity	sorority
bellboy	bellgirl
duke	duchess
ballet_dancer	ballerina
dudes	chicks
fiance	fiancee
colts	fillies
husbands	wives
suitor	suitress
paternity	maternity
he	she
businessman	businesswoman
masseurs	masseuses
hero	heroine
deer	doe
busboys	busgirls
boyfriends	girlfriends
kings	queens
brothers	sisters
masters	mistresses
stepfather	stepmother
grooms	brides
son	daughter
studs	minxes
cowboy	cowgirl
mentleman	lady
sons	daughters
baritone	mezzo
salesman	saleswoman
paramour	mistress
male_host	hostess
monks	nuns
menservants	maids
mr.	mrs.
headmasters	headmistresses
lads	lasses
congressman	congresswoman
airman	airwoman
househusband	housewife
priest	priestess
barmen	barwomen
barons	barnoesses
abbots	abbesses
handyman	handywoman
beard	toque
fraternities	sororities
stewards	stewardesses
colt	filly
czar	czarina
stepsons	stepdaughters
himself	herself
boys	girls
lions	lionesses
gentleman	lady
penis	vagina
his	hers
masseur	masseuse
bulls	cows
uncles	aunts
bloke	wench
beards	toques
hubby	wife
lion	lioness
sorcerer	sorceress
macho	effeminate
father	mother
gays	lesbians
male	female
waiters	waitresses
sperm	ovum
prostate	skene_gland
stepson	stepdaughter
prostatic_utricle	womb
businessmen	businesswomen
heir	heiress
waiter	waitress
headmaster	headmistress
man	woman
governor	governess
god	godess
bridegroom	bride
grandpa	grandma
groom	bride
dude	gal
gay	lesbian
gents	ladies
boy	girl
grandfather	grandmother
gelding	mare
paternity	maternity
roosters	hens
prostatic_utricle	uterus
priests	nuns
manservants	maidservants
stailor	seamstress'
busboy	busgirl
heros	heroines
cowboy	cowgirl
cowboys	cowgirls
camerawomen	cameramen
cameraman	camerawoman
busboy	busgirl
busboys	busgirls
bellboy	bellgirl
bellboys	bellgirls
barman	barwoman
barmen	barwomen
tailor	seamstress
tailors	seamstress'
prince	princess
princes	princesses
governor	governess
governors	governesses
adultor	adultress
adultors	adultresses
god	godess
gods	godesses
host	hostess
hosts	hostesses
abbot	abbess
abbots	abbesses
actor	actress
actors	actresses
bachelor	spinster
bachelors	spinsters
baron	baroness
barons	barnoesses
beau	belle
beaus	belles
bridegroom	bride
bridegrooms	brides
brother	sister
brothers	sisters
duke	duchess
dukes	duchesses
emperor	empress
emperors	empresses
enchanter	enchantress
father	mother
fathers	mothers
fiance	fiancee
fiances	fiancees
priest	nun
priests	nuns
gentleman	lady
gentlemen	ladies
grandfather	grandmother
grandfathers	grandmothers
headmaster	headmistress
headmasters	headmistresses
hero	heroine
heros	heroines
lad	lass
lads	lasses
landlord	landlady
landlords	landladies
male	female
males	females
man	woman
men	women
manservant	maidservant
manservants	maidservants
marquis	marchioness
masseur	masseuse
masseurs	masseuses
master	mistress
masters	mistresses
monk	nun
monks	nuns
nephew	niece
nephews	nieces
priest	priestess
priests	priestesses
sorcerer	sorceress
sorcerers	sorceresses
stepfather	stepmother
stepfathers	stepmothers
stepson	stepdaughter
stepsons	stepdaughters
steward	stewardess
stewards	stewardesses
uncle	aunt
uncles	aunts
waiter	waitress
waiters	waitresses
widower	widow
widowers	widows
wizard	witch
wizards	witches
driver	attendant
supervisor	cashier
janitor	teacher
cook	nurse
mover	assistant
laborer	secretary
construction worker	auditor
chief	cleaner
developer	receptionist
carpenter	clerk
manager	counselor
lawyer	designer
farmer	hairdresser
salesperson	writer
physician	housekeeper
guard	baker
analyst	accountant
mechanic	editor
sheriff	librarian
CEO	tailor
Active	Affectionate
Adventurous	Child
Aggress	Cheer
Ambitio	Commit
Analy	Communal
Assert	Compassion
Athlet	Connect
Autonom	Considerate
Boast	Cooperat
Challeng	Depend
Compet	Emotiona
Confident	Empath
Courag	Feminine
Decide	Flatterable
Decisive	Gentle
Decision	Honest
Determin	Interpersonal
Dominant	Interdependen
Domina	Interpersona
Force	Kind
Greedy	Kinship
Headstrong	Loyal
Hierarch	Modesty
Hostil	Nag
Implusive	Nurtur
Independen	Pleasant
Individual	Polite
Intellect	Quiet
Lead	Respon
Logic	Sensitiv
Masculine	Submissive
Objective	Support
Opinion	Sympath
Outspoken	Tender
Persist	Together
Principle	Trust
Reckless	Understand
Stubborn	Warm
Superior	Whin
Self-confiden	Yield
Self-sufficien	Affectionate
Self-relian	Child
Active	Cheer
Adventurous	Commit
Aggress	Communal
Ambitio	Compassion
Analy	Connect
Assert	Considerate
Athlet	Cooperat
Autonom	Depend
Boast	Emotion
Challeng	Empath
Compet	Feminine
Confident	Flatterable
Courag	Gentle
Decide	Honest
Decisive	Interpersonal
Decision	Interdependen
Determin	Interpersona
Dominant	Kind
Domina	Kinship
Force	Loyal
Greedy	Modesty
Headstrong	Nag
Hierarch	Nurtur
Hostil	Pleasant
Implusive	Polite
Independen	Quiet
Individual	Respon
Intellect	Sensitiv
Lead	Submissive
Logic	Support
Masculine	Sympath
Objective	Tender
Opinion	Together
Outspoken	Trust
Persist	Understand
Principle	Warm
Reckless	Whin
Stubborn	Yield
Superior	
Self-confiden	
Self-sufficien	
Self-relian	
	
	accessories
	adorable
	adore
Against	attractive,
Answer	beads
Arms	beautiful
Articles,	beauty
Back	boutique
Band	bracelet
Bass	bridal
Batman	bride
Battle	butterfly,
Bear	candles
Beat	ceramic
Beer	charming
Blues	chic
Brain,	clothes
Brother	clothing
Brothers	coats
Bull	cocktail,
Camp	colorful
Champion	colors
Cold	colours
Comedy	coral
Cool,	costume
Count	costumes
Crew	crafts
Da	crystal,
Dead	crystals
Death	cute
Devil	dancers
Die	decor
DJ	decorating
Dog	decorations
Dragon	delicate
Eagle,	delightful
Empire	designer
End	designs
EP	doll
Essential	dolls
Evil	dress
Evolution	dresses
Fans	earrings
feat	elegance
Fight	elegant
Fish,	ensemble
Flying	exotic
Force	exquisite
Four	fabric
Future	fabrics
Game	fabulous
Ghost	fairy
Giant	fashion
Great	fashionable
Green	feminine
Guitar,	floral
Gun	flower
Guys	flowers
Hat	footwear
Head	fragrance
Hero	gorgeous
Hood	gown
	hair
	handbags
Iron	handmade
	heels
Jazz	invitations
Jump	jewellery
King,	jewelry
Kingdom	knit
Kings	knitting
Knight	lace,
Late	ladies
Leader	lip
Legend	lovely
Lincoln	makeup
Lion	metallic
LP,	necklace
Major	nylon
Man	outfit
Mario	outfits
Marvel	paired
Master	pale
Max	pattern
Military	pearl
Motion	pendant
Nation,	perfume
Navy	pillow
Numbers	pink,
Of	platinum
Official	polish
Orchestra	princess
Original	prom
Oxford	purple
Pack	purse
Part,	quilt
Pass	ribbon
Points	romantic
Prime	roses
Prince	satin
Quote	scent
Rank	sewing
Raw	sheer
Records	silk
Remix,	skirt
remix	sleek
Reserve	stitch,
Retrieved	stunning
Return	styling
Revolution	stylish
Rise	sweater
Rock	themed
Rocky,	tiny
Roll	trendy
Rule	vibrant,
Running	Vuitton
Rush	waist
Score	wardrobe
Scottish	wear
Shirt	wedding
Shot	weddings
Six	wonderful,
Sound,	yarn
Stand	Celebrities and Modeling: AMI
Strong	authors
Super	availability
Ten	bio
Tiger	blogger
Trail	bloggers
Trial	blogs
Ultimate	bookmark
views	browse
Vol,	cell
Volume	checkout
Wall	class
War	classes,
Wars	clicks
Way	cluster
Will	collections
Wolf	contacting
Big Tech: .0	coordinates
1.1	cosmetic
2	coupon,
3	curves
Android	date
Answers	designers
API	dot
App	engagement
Applications,	giveaway
Audio	goodies
Build	inexpensive
Canon	info
Cisco	invites
Cloud	layout
Command	libraries
Computer	litter
contribs,	magazine
CPU	magazines,
demo	markers
developer	matching
Developer	measurements
developers	membrane
Documents	model
Error,	modeling,
Firefox	models
Flash	ms
Forums	newest
Galaxy	null
Gaming	on-line
GMT	patterns
Google	peek
GPS	photograph
HP,	photos
IBM	photostream
Install	pictures
Intel	pumps
Intelligence	registry
Internet	reserved
Introduction	royalty
iOS	sample
iPhone,	samples
Java	scans
JavaScript	separated
Linux	shipping
Message	shopping
Microsoft	shops
MP3	spanish,
NET	stamps
Nintendo,	stores
Notes	strips
OS	supermarket
PC	swap
Player	temp
plugin	template
Problem	templates,
Programming	trends
PS3	triangle
Questions	updated
Re	websites
RE	widget
Remote	Cooking and Kitchen: bake
replies	Bake
RSS	baked
Samsung	baking
Security	cake
SEO	cakes,
Server,	chocolate
SMS	Chocolate
Software	cinnamon
SQL	coconut
Statistics	Cookies
Test	Cooking
User	cream,
Users	creamy
Wii	crust
Windows,	cups
Wireless	dairy
Xbox	delicious
XML	Delicious
XP	dessert
YouTube	dressing,
Engineering and Automotive: AC	egg
Advance	eggs
Audi	foods
Auto	Ginger
Automotive	homemade
Bar	honey
Battery	Ingredients
BMW	lemon,
Built	milk
Button	Milk
Cap	nutrition
Charger	organic
Chevrolet	pumpkin
Chrome	recipe
Circuit	Recipe
Construction	recipes,
Contractors	Recipes
Custom	Salad
Dodge,	spice
Doors	spicy
Driver	sugar
Driving	sweet
Duty	tea
Economy	teaspoon
Electric	tsp
Engine	vanilla,
Engineer,	vegan
Engineering	vegetables
Equipment	vegetarian
Extra	veggies
Fishing	yogurt
Fuel	yummy
Garage	Fashion and Lifestyle: Autumn
Gas	Bag
Gear,	Bags
General	Ballet
GM	Barbie
Golf	Basket,
Guard	Bathroom
Hardware	Beads
Heating	Beautiful
Heavy	Beauty
Honda	Bed
Industrial	Bedroom
Laser	Bee
Logo	Bottom,
Machine	Boutique
Maintenance	Bracelet
Manual	Bridal
Manufacturing,	Bride
Metal	Butterfly
Motor	Cake
Nissan	Candle
Oil	Candy,
Pocket	Carnival
Portable	Carpet
Power	Ceramic
Premium	Charm
Pressure	Cherry
Printing	Clearance
Pro	Clothes
Quick	Colors
Racing	Compact
RC	Contemporary
Repair	Cookie
Rod	Coral
Signs	Costume
Solar,	Cottage,
Solid	Covers
Speed	Crafts
Sport	Cream
Standard	Crystal
Steel	Daisy
System	Dance
Tech	Dancing
Technical	Decor
Tool,	Designer
Tools	Designs
Toyota	Desk
Trade	Diamonds
Trading	Dining
Training	DIY
Transfer	Doll
Transport	Dolls
Truck,	Dreams,
Universal	Dress
Upper	Dresses
Wood	Earrings
Yamaha	Egg
Engineering and Electronics: assembly	Emerald
audio	Evening
auto	Fabric
automotive,	Fairy
backup	Fancy,
batteries	Fashion
blade	Favorites
brass	Fiber
build	Floor
built	Floral
capable	Flower
charge	Flowers
charging	Giveaway,
chip	Gorgeous
circuit	Hair
command	Halloween
commands	Heart
computing	Heated
conditioning,	Honey
console	Inspired
construction	Jeans,
contractor	Jewelry
contractors	Kiss
controller	Kitty
conversion	Lace
convert	Ladies
converted	Laundry
custom	Layer
dealer	Lovely
dealers	Loving,
driver	Luxury
durable,	Makeup
duty	Mesh
electronics	Metallic
enabled	Mint
engine	Mirror
engineer	Mirrors
engineering	Nail
engineers,	Natural
engines	Necklace
enterprise	Nylon
execution	Passion
formation	Pattern
gate	Patterns
gear	Pearl
general	Perfect
generation	Picture
header	Pillow
install	Pink
legacy	Platinum
lightweight	Plus
logic	Powder
manual	Pretty
master,	Princess
motor	Printed,
operation	Pump
physics	Queen
pipe	Rack
power	Ribbon
printer	Romance
printing	Romantic
proven,	Rose
receiver	Roses
reference	Ruby,
remote	Salon
repair	Satin
replace	Shades
replacement	Shape
restoration,	Shipping
rod	Shoes
root	Shoulder
scheme	Shower,
seal	Silk
security	Simply
setup	Skin
software	Sleeping
solution	Smile
superior,	Soap
suspension	Soft
tire	Spice
transfer	Split
trucks	Style,
upgrade	Sugar
God and Religion: Abraham	Summer
according	Sunny
According	Swan
Allah	Sweet
appointed	Swim
authority	Tea
bear	Tops
bears	Tote
believed	Trend,
Bible	Trim
blind	Tropical
brothers	Twilight
century	Unique
Christ	Valentine
Christianity	Vampire
Christians	Vanity
commentary	Venus,
composed	Victorian
creator	Vintage
evil	Wear
evolution	Wedding
Father	Weddings
favor	Witch
followers	Womens,
fool	Wonderful
genius	Wrap
glory	Health and Relationships: abortion
God,	acne
god	addicted
Gospel	addiction,
he	allergic
He	allergy
himself	arthritis
His	aunt
Holy	babies
holy	belly
hundred	breast
Islam	cancer
Israel,	caring,
Jerusalem	celebrities
Jesus	celebrity
Jews	chatting
king	cheating
kingdom	clinic
land	complications
Lord	counseling
man	couple
mere	couples
Muslims	dancer
nations	DD
passage	depressed
philosophy	depression
poor	diabetes,
Pope	disabilities
possession	disorder
praise,	distress
principle	donor
quote	emotionally
referred	experiencing
refers	girlfriend
regard	grandmother
regarded	healthier
respect	her
reward,	hers
Roman	herself
Rome	hips
rule	hormones,
sacrifice	inspirational
sheep	lady
sin	literacy
sir	lover
Son	loving
sword	marriage
temple,	messy
theory	mom,
tho	moms
thou	mother
Thus	mothers
tradition	mum
translation	nurse
united	nurses
unto	nursing
verse,	obsessed
wise	obsession
worthy	oral
ye	parent
Sports: backs	parenting
ball	passionate
band	poems
baseball	pose
basketball	poses
bass	pregnancy
bat	pregnant
beat	protective
beaten,	relationship
beating	relationships
beer	romance,
bench	seniors
betting	sensitive
blues	sexuality
boss	she
buddy	She
camp	sister
captain,	sisters
champion	skin
championship	stories,
cheat	stressful
coach	supportive
coaches	survivors
coin	syndrome
crew	therapist
decent	therapy
defensive	toes,
don	toxic
draft	tumor
drum	vampire
drums	witch
dude	wives
elite	woman
epic	women
era	Luxury and Lifestyle: accommodations
fans,	Apartment
fellow	balcony
finest	bath,
fishing	bathroom
football	bathrooms
franchise	beaches
gambling	bedroom
game	carpet
games,	catering
gaming	closet,
golf	cottage
grand	cozy
great	cruise
greatest	Enjoy
guard	enjoys
guitar	flats
guy	gardening
guys	holidays
heads,	intimate
hero	kitchen
hockey	laundry
hunting	luxurious
idiot	luxury
injuries	massage
injury	mattress
jazz	outdoors
jersey	pets
jokes,	queen
kick	relaxing
league	rooms
legend	Rooms
legendary	salon
lineup	sandy
manager	shower,
mark	showers
mate	soap
minor	Spa
musicians	spa
offense	sunny
offensive	swim
pass	swimming
passes	tile
passing	tub
penalty	vacations,
pit,	wellness
pitch	yoga
player	Web Article Titles: Absolutely
players	Acne
points	Across
pound	Addiction
premier	Adelaide,
prime	Advertise
pro	Affordable
prospect,	Alberta
prospects	Apply
racing	Aurora
rally	Awareness
rank	Bachelor
recruiting	Benefit
retired	Biggest
rotation	Blogger
rush,	Bollywood
saves	Breast
score	Calendar
scored	Cancel,
scoring	Cancer
serving	Caribbean
solid	Celebrity
sport	Changing
sports	Choice
squad,	Choosing
stadium	Classes,
starter	Closed
stats	Collections
suspended	Compliance
tackle	Consumer
team	Consumers
teams	Contest,
thread	Coordinator
ton,	Counseling
tournament	Created
trade	Cruise
trading	Cure
tribute	Czech
tricks	Dakota,
ultimate	Dates
versus	Denmark
veteran,	Designers
victory	Destination
wing	Diabetes
yard	Diet
yards	Disclaimer,
zone	Eating
War and Violence: against	eBook
Army	Editorial
army	Engagement
arrest	ER
arrested	Everyday
attack,	Exclusive
ban	Explore
battle	Factor
bin	Fiction
Bush	Finding
charges	Fitness
chief	Food
cited	Foods
combat	Gallery
commit	Getting
committed	Health
corruption	Healthy
crimes	Holidays
criminal	Inspiration
dead	Languages
defeat	Libraries,
defeated	Lifestyle
defense,	Lots
Defense	Magazine
destruction	Massage
enemies	Model
enemy	Models
executed	Month
fight	MS,
fighter	MSN
fighting	Multiple
fights	Naturally
fought	Newsletter
fraud	non-profit
governor	nonprofit
gun	Novel,
guns	Nurse
heroes	Nursing
illegal	Nutrition
injured	Oral
intelligence	Parties
Iraq	Patent
Iraqi	Patient
kill	Platform,
killed	Pregnancy
killing	Privacy
leader	Purchase
leaders,	Readers
leadership	Reality
led	Recently
march	Reception,
military	Registry
minister	Relationship
officers	Relationships
opponents	Reserved
opposition	Rica
personnel	Runtime
prison	Sample
province	Scenes
racist	Secret
regime	Secrets
revolution	Seller
ruled,	Shared
soldier	Shares
soldiers	Sharing
spokesman	Shows,
supporters	Sierra
tactics	Sites
terror	Spotlight
terrorist,	Statement
troops	Student
veterans	Target
violent	Teacher
war	Teachers
wars	Templates
weapons	Therapy
	Totally
	Treat
	Trends
	Updates
	VIP
	Virgin,
	Virtual
	Vitamin
	Voices
	Wellness
	Whole
	Winners
	Women
	Write,
	Yoga
